1111111111111
1C010000000C1
1000011111001
100011E000001
1011111111111
1011111111111
1000000111111
100000P111111
1111111111111